22222222222222222222222222222222222222222222222222222222222
23322222222222222122222222222222222222222222222222222222222
33333222222222222212222222222222222222222222222222222222222
33333222222222111112222222222222222222222222222222222222222
33333322222222211122222222222222222222222222222222222222222
23333222222222221222211222222222222222222222222222222222222
22332222222222221222211222222222222222222222222222222222222
22222222222222222222222222222222222222222222222222222222222
22222222222222222222222222222222222222222222222222222222222
22222222222222222222222222222222222222222222112222222222222
22222222222222222222222222222222222222222211112222222222222
22222222222222221222222222222222222222222211112222222222222
22222222222222222222222222222222222222222211111222222222111
22222222222222112222222222222222222222222211112222222221101
22222222222112222222222222222222222233222222222222222211000
22222222222222222222222222222222222333222222222222222211000
22222222222222222222222222222222333233222222222222222221111
22222222222222222222222222222322333333222222222222222222222
22222222222222222222222222222222333222222221122212222222222
22222222222222222222222222222222222222222222222222222222222
22222222222222222222222222222222222222222222222222222222222
22222222222222222222222222222222222222222222222222222222222
22222222222222222222222222222222222222222222222222222222222
22222222222232222222222222222222222222222222222221112222222
22222222222222222222222222222222222222222222222222211112222
11222222222222222222222222222222222222222222222222221122222
22222222222222222222222222222222222222221222222222221122222
22222222222111111122222222222222222222222112222222111111112
22222222221111100111111122222222222222222222222211111111111
22222222221110000011112222222222222222222222222211001110000
22222222211110000011222222222222222222222222222221111111001
22222222111100001111222222222222222222222222222222222222111
22222211111100011122222223323222222222222222222222222222222
