22222221112222222222222222222221121111222222222222222222222
22222222222222222222222222222222222112222222233222222222222
22222222222222222222222222222222222222222333333222222222222
22111222222222222222222222222222222222222222233322222222222
22111111222222222222222222222222222222222222223333332222222
22110011111222222222222222222222222222222222222223333333322
21100000011122222222222322222222222222222222222223332223333
22110000001111112222222222222222222222222222222222322222333
22211000000111222222222222222221222222222222222222222223322
22110000001112222222222222222221111112222222222222222222222
22211000000122222222222222222222111111222222222222222222222
22211110000112222222222222222222111111222222222222222222222
22221111000011111222222222222221111111222222222222222222222
22222221111111112222222222222111101111222222222222222222222
22222222111222222222222222222211111111222222222222222222222
23222222222222222222222222222222212222222222222222222222222
33322222222222222222222222222222222222222222222222222222222
23332222222222222222222222222222222222222222222222222222222
22222222222222222222222333222222222222222222222222222222222
22222222222212222222222333333233322222222222222222222222222
2222222222222222222222233333333222222222222222222222222222
22222222222222222222222333333322222222222222222222222222222
22222222112222222222222223322222222222222222222222222222222
22222222122222221122222222222222222222222222222222222222222
22222222221122211112211222222222222222222222222222222222222
21122222222222221222212222222222222222222222222222222222222
22222222222222222222222222222222222222222222222222222222211
22222222222222222222222222222222222222222222222222222222111
22222222222222222222222222333222222222222221222112222222111
22222222222222222222222233333322222222222222222112222122111
22222222222222222222222223333222222222222222222122222222222
22222222222222222223332222222222222222222222221111112222222
22222222222222222222222222222222222222222222222222122222222
