00000000000000000000000000000000000000000000000000000000000
00000000000000000000000000002000000000000000000000000000000
00000011111111111000000022000000000000000000000000000000000
00000002000000000020000000000000000000000000011111111100000
00002000000000000000000000000200000000000000000000000000000
00000000000000111111111000000000020000000200000000000000000
00000200000000000000000000000000000000000000000000000000000
00000000000000000000000000000002000000022200000000000000000
00002000000000000000000000000000000000020000000000000000000
00000000200000000011111111100000000000000000000000000200000
00000000000000000000000000000000000000000000200000000000000
00000000000000000000000000000020000000000000000000000000000
00020000000000000000000000000000000000000000000111111111000
00000000000111111111000000000000020000000000000000000000000
00000200000000000000000000000000000000000000000000000000000
00000000000000000000000000000000000000200000000000000000000
00000000000000000000000000000000000000000000000000000000000
00000200000000000000000000000001111111110000000000020000000
00000000000020000000000000000000000000000000000000000000000
00002000000000000000000000000000000000000000000000000000000
00000000011111111100002000002000000000000200000000000000000
00000000000000000000000000000000000000000000011111111100000
00002000000000000000020000000000002000000000000000000000000
00000020000000200000000000000000000000000000000000000000000
