22111111111111222222222222222222222222222222222222111111122
22222111111112222222222222222222222222222222222222111111122
22222222222212222222222222222222222222222222222222211111122
22222222222222222222222222222222222222222222222222222222222
22222222222222222222222222222222222222111111111111222222222
22222222222222222222222222222222222222222111111111222222222
22222222222222222222222222222222222222222211111111222222222
22222222221122222222222222222222222222222222111111111111112
22222211222122222222222222222222222222222222111011111111111
22222111222222222222222222222222222222222222211011111111111
22221111222222222222222222222222222222222222211111111111111
22221111222222222222222222222222222222222222221111111111112
22211111222222222211112222222222222222222222211111111111122
22221111222222211111000112222222222222222222211111122211222
22222221111111111111000011222222222222222222111111112222222
22222221111111111111000001122222222222222222111111222222222
22222222111100011111000011112222222222222222112221122222222
22222221111001111111101111112222222222222222222222222222222
22222221111111111111111111122222222222222222222222222222222
22222221111110111111111111122222222222222222222222222222222
22222211110111112221111222222222222222222222222222222222222
22222111111111111222221222222222222222222222222222221111222
22222111111111111222222222222222222222222222222222222112222
22222211111111112222222222222222222222222222222222222222212
22221111111111122222222222222222222211111111222222222222212
11121111111111122222222222222222222111000111111122222222222
11122221111111222222222222222222222111000000000112222222222
11222221111111122222222222222222222111111000000011122222222
22222222222221122222222222222222221111111000000011122222222
22222222222222222222222222222222222122111110000001112222222
12222222222222222222222222222222222222222111000000111122222
22222222222222222222222222222222222222221111100001111122222
22222222222222222222222222222222222222222111111111111122222
