222222222222222222222222222211111111100111112222222222221111122222222222111111112
222222222222222222222222222221111111111111111222222222222111122222222222111111122
222222222222222222222222222222111111111111122222222222222222222222222222221112222
222222222222222222222222222222111111111111112222222222222222221111222222222222222
222222222222222222222222222211111111111111112222222222222222221111121122222222222
222222222222222222222222222211111111111111112222222222222222222111122222222222222
122222222222222222222122211111111111111111112222222222222222222211122222222222222
122222222222222222222222211111111111111111122222222222222222222222122222222222222
112222222222222222222222221111111111100011122222112222222222222222222222222222222
112222222222222222221112221111100000000001111111112222222222222222222222222222222
222222222222222222221112211111000000000000111111112222222222222222222222222222222
122222222222222222222222111110000000000000011111111122222222222222222222222222222
222222222222222222222222211100000000000000001111111111122222222222222222222222222
112222222222222222222222221110000000000000000111111111122222222222222222222222222
112222222222222222222222222110000000000000001111111222222222222222222222222222222
111222222222222222222222222110000000000001111111122222222222222222222222222222222
211222222222222222222222222111110000000011111112222222222222222222222222222111112
222222222222222222222222222211111000000001111111222222222222222212222222221111111
222222222222222222222222222221111100000000001111222222222222111111111111111000011
222222222222222222222222222221111100000000001111112222222222111111111111100000000
222222222222222222222222222221111110000000011111111122211211110000000000000000000
222222222222222222222222222221111111111100011111111111111111100000000000000001111
222222222222222222222222222221111111111111111111111111111110000000000000000111111
222222222222222222222222222222111111111111111111111111111000000000000000001111111
222222222222222222222222222222221222111111111111111111000000000000000000001111111
222222222222222222222222222222221111111111111111111111100000000000000000011111111
222222222222222222222222222222222222222211111122222211110000000000000000011112111
222222222222222222222222222222211111122222222222222211111000000000111101111122111
222222222222222222222222222222111111111122222222222221111000000011111011112222111
222222222222222222222222222222111111111222222222222221110000000111100011111122211
211111222222222222222222222211111211111222222222212222110000011111111000111111112
221111222222222222222222222111122122222222222222112222211111111111110000011111112
211111222222222222222222222111111222222222222222222222111111111111100000000011122
111111111222222222222222222111112222222222222222222222111111111111100000000011222
221111111112222222222222222211122222222222222222222222221111111111111110001111222
221111111111222222222222222222222222222222222222222222222211111111111111111111211
222111111111222222222222222222222222222222222222222222222211111111111111111111111
222222112222222222222222222222222222222222222222222222222211111111111111111111111
222222222222222222222222222222222222222222222222222222222211111111111111111111111
222222222222222222222221112222222222222222222222222222222111111111111111111111111
222222222222222222111111111111222222222222222222222222222111100011111111111111111
222222222222222221111000111111111122222222222222222222222110000000111111112222211
222222222222222211110000011110001111121111122222222222221110000000111111222222211
222222222222222211110000001000000000111111111222222222221110000001111111122222222
222222222222222221110000000000000000011111111122222222221111110001111122222222222
222222222222222221110000000000000000001111111122222222222111000011111122222222222
222222222222122211111000000000000000011111111122222222222111111111111222222222222
222222222222122222111100000000000000111110011112222222211111111111222222222222222
222222222222222222221111000000001001111111111111122221111111111112222222222222211
222222222222222222222221111000111111111111111111111111111111111111222222222222222
222211222222222222222222211111112111112211111111112221111111111111111222222222222
